NO ./maps/texture/wall_north.xpm
SO ./maps/texture/wall_south.xpm
WE ./maps/texture/wall_west.xpm
EA ./maps/texture/wall_east.xpm

F 220,100,0
C 225,30,100

111111111111111
100000000000001
100000000000001
100000001000001
100000000000001
100000010000001
100000000000001
100000000000001
100100001000001
100000000000001
111111111111111
111111111111111
111111111111111
111111111111111
111111111111111
111111111111111
111111111111111



