NO ./maps/texture/wall_north.xpm
SO ./maps/texture/wall_south.xpm
WE ./maps/texture/wall_west.xpm
EA ./maps/texture/wall_east.xpm

F 0,100,0
C 225,30,100

11111
10101
11E11
10101
11111
